maxEnemies 4
minEnemies 2
waves 2
3 3 3 3 3 ^ 3 3 3 3 3
3 2 2 2 2 0 2 2 2 2 3
3 1 1 1 1 0 1 1 1 1 3
3 0 0 0 0 0 0 0 0 0 3
3 0 0 3 3 0 0 0 0 0 3
2 0 0 3 3 0 0 0 0 0 2
1 0 0 2 2 0 0 0 0 0 1
< 0 0 1 1 0 0 3 0 0 >
3 0 0 0 0 0 3 3 0 0 3
3 0 0 0 0 0 2 2 0 0 3
3 0 0 0 0 0 1 1 0 0 3
3 0 0 0 0 0 0 0 0 0 3
3 3 3 3 3 0 3 3 3 3 3
3 3 3 3 3 0 3 3 3 3 3
3 3 3 3 3 v 3 3 3 3 3