2 2 2 2 ^ 2 2 2 2
2 0 0 0 0 0 0 0 >
2 0 0 0 0 0 0 0 2
2 0 0 0 0 0 0 0 2
2 0 0 0 0 0 0 0 2
2 0 0 0 0 0 0 0 2
< 0 0 0 0 0 0 0 2
2 2 2 2 v 2 2 2 2
